11111111111111111
10000001000100001
10000001000100001
10000001100100001
10000000110100001
10000000000000001
10000000000000001
10000000000000001
11110110000000001
10000010000000001
10000011000000001
11111111111111111